+   +---+---+---+---+---+
|   |                   |
+   +   +---+---+---+---+
|   |       |           |
+   +   +   +   +---+   +
|   |   |           |   |
+   +---+   +---+---+   +
|       |   |       |   |
+---+   +---+   +   +   +
|               |       |
+---+---+---+---+---+   +
